##############################
#    ...          ...        #
######## ##########.##########
#             #............  #
#  ######## ######### ####.###
#           ...............  #
# ########## #################
#          # #               #
#          # #               #
#............................#
##############################